/assets/map.txt
###########
#.@.......#
#TTT......#
#.........#
#####D#####